Possible completions are:
driver.add_cookie 	driver.add_credential
driver.add_virtual_authenticator 	driver.application_cache
driver.back 	driver.bidi_connection
driver.capabilities 	driver.caps
driver.close 	driver.command_executor
driver.create_web_element 	driver.current_url
driver.current_window_handle 	driver.delete_all_cookies
driver.delete_cookie 	driver.delete_network_conditions
driver.desired_capabilities 	driver.error_handler
driver.execute 	driver.execute_async_script
driver.execute_cdp_cmd 	driver.execute_script
driver.file_detector 	driver.file_detector_context
driver.find_element 	driver.find_elements
driver.forward 	driver.fullscreen_window
driver.get 	driver.get_cookie
driver.get_cookies 	driver.get_credentials
driver.get_issue_message 	driver.get_log
driver.get_network_conditions 	driver.get_pinned_scripts
driver.get_screenshot_as_base64 	driver.get_screenshot_as_file
driver.get_screenshot_as_png 	driver.get_sinks
driver.get_window_position 	driver.get_window_rect
driver.get_window_size 	driver.implicitly_wait
driver.launch_app 	driver.log_types
driver.maximize_window 	driver.minimize_window
driver.mobile 	driver.name
driver.orientation 	driver.page_source
driver.pin_script 	driver.pinned_scripts
driver.print_page 	driver.quit
driver.refresh 	driver.remove_all_credentials
driver.remove_credential 	driver.remove_virtual_authenticator
driver.save_screenshot 	driver.service
driver.session_id 	driver.set_network_conditions
driver.set_page_load_timeout 	driver.set_permissions
driver.set_script_timeout 	driver.set_sink_to_use
driver.set_user_verified 	driver.set_window_position
driver.set_window_rect 	driver.set_window_size
driver.start_client 	driver.start_desktop_mirroring
driver.start_session 	driver.start_tab_mirroring
driver.stop_casting 	driver.stop_client
driver.switch_to 	driver.timeouts
driver.title 	driver.unpin
driver.vendor_prefix 	driver.virtual_authenticator_id
driver.window_handles
